.......11T1111
.............0
......X.....*0
.....000...000
.X.@.0.....0..
000000000000..
