.........00.........................
.........0..........................
X..0.X...0...00000000.X..000000.....
X@X0XXX.X0X....0...0000000....000...
0000000000000..0................0...
.........0.....0............0...0000
.........0..0000............0......0
.........T........000.....0000.000.T
.........0..........0.......0.^.0..0
.........0....0....X0X.....X01110*00
.........0X.X.0XX.XX000X.XXX0...000.
.........000000000000.0000000.......
