.000.......
...0.......
...T.X...X.
...0XX@X.XX
...00000000
.........*0
00000.00000
....0^0....
....000....
