.111T111111111T11...............
11..............................
0...............................
0..........@....................
0c..a.X....X.........X..X.......
0X..X.X..c.X..X.b...XX..X.X.....
000000000000000000000000000000..
..........0.........0*..........
..........0.........0...........
..........00.a.X.X.b0...........
...........0000000000...........
^^^^^^^^^^^..........^^^^^^^^^^^
00000000000..........00000000000
