..............X
............000
..............0
.......X.000..T
@......X.0....0
X..0...X.T..000
X.X0..XX.0*....
000000000000...
