# 1:48
..1111111111111111
..0.......@......0
..0.....000......0
..0..............0
..T..............0
..0........^.....0
.01........1.....0
.0*.........X....0
00000.......1....0
.0.........^1....0
.0........^11...X0
.0.X......11...XX0
.0.X.1........XXX0
.00000000000000000
