.1111111111111111
.0.......@......0
.0.....000......0
.0..............0
.0..............0
.0........^.....0
01........1.....0
0*.........X....0
0111.......1....0
0.........^1....0
0........^11...X0
0.X......11...XX0
0.X.1........XXX0
00000000000000000
