00000000000000000000
0........0.........0
0........0.........0
0........0.........0
0........0.........0
0........0.........0
0........0.........0
0.XX.....0.........0
0bXX...a.0X.c.@.d..0
00000000000000000000
0.........0........0
0.........0........0
0.........0........0
0.........0........0
0.00......0........0
T..0......0........0
0..0......0........0
0*.0a.d...0.c.X..b.0
00000000000000000000
