00000000000000000000
0........0.........0
0........0.........0
0........0.........0
0........0.........0
0........0.........0
0..X.....0.........0
0.XX.....0X........0
0bXX...a.0X.c.@.d.X0
00000000000000000000
0...X.....0........0
0.........0........0
0.........0........0
0.........0........0
0.00......0........0
T..0......0........0
0..0......0....X...0
0*.0a....d0.c.XX.bX0
00000000000000000000
