*...............T
0...............0
0....X..........0
0...hX.....a.@.a0
0000000....000000
.
.
X.......^^h
0000000000000
# This is a comment
