..00T0000000000T0....
..0..................
000..................
0......000.......T000
0.......0...........0
0.@.XXXX0X.........*0
00000000000...0...000
..........0...0...0..
..........000000000..
