..11T1111111111T1....
..0..................
000..................
0......000.......T111
0.......0...........0
0.@.XXXX0X.........*0
00000000000...0...000
..........0...0...0..
..........000000000..
