.........00.........................
.........0..........................
X..0.X...0...00000000.X..000000.....
X@X0XXX.X0X....T...0000000....000...
0000000000000..0................T...
.........0.....0............0...0000
.........0..0000............0......0
.........T........000.....0000^000.0
.........0..........0.......0.0.0..0
.........0....0....X0X.....X0...0*00
.........0X.X.0XX.XX000X.XXX0...000.
.........000000000000.0000000.......
