T.....................X0.
0.....................X0.
0....................XX0.
0*...X...............000.
00...0.X.....0....0..0...
.0...0.X....00.X.@0000...
.00..0.XXX...0.XXX0......
..0..00000000000000......
..00.0...................
...000...................
