........0T0.........
.......0...0........
.......T.....0..00000
.....0.......00....0
....0.....X........0
...T......XX......X0
..0.......000....XX0
.0............@.0000
0.............X....0
0*...........000...0
00....00...0......X0
.0....00X..00...0000
.0....0000000..00...
.000..0.....0.00....
...0.00.....000.....
...000..............
