0X.........0
0XX......*.0
0000.....0.0
0....00....0
0...0.....X0
0X.......@X0
0XXXX....XX0
0XXXXX.XXXX0
000000000000
